11111111111111111111111111111111111111111111111111111111111111111111111111111111111111111111100000000000000000000000000000000000
10000000000000000000000000000000000000000000000000000000000000000000000000000000000000000000100000000000000000000000000000000000
10000000000000000000000000000000000000000000000000000000000000000000000000000000000000000000100000000000000000000000000000000000
10000000000000000000000000000000000000000000000000000000000000000000000000000000000000000000100000000000000000000000000000000000
10000000000000000000000000000000000000000000000000000000000000000000000000000000000000000000100000000000000000000000000000000000
10000000000000000000000000000000000000000000000000000000000000000000000000000000000000000000100000000000000000000000000000000000
10000000000000000000000000000000000000000000000000000000000000000000000000000000000000000000100000000000000000000000000000000000
10000000000000000000000000000000000000000000000000000000000000000000000000000000000000000000100000000000000000000000000000000000
10000000000000000000000000000000000000000000000000000000000000000000000000000000000000000000100000000000000000000000000000000000
10000000000000000000000000000000000000000000000000000000000000000000000000000000000000000000100000000000000000000000000000000000
10000000000000000000000000000000000000000000000000000000000000000000000000000000000000000000100000000000000000000000000000000000
10000000000000000000000000000000000000000000000000000000000000000000000000000000000000000000100000000000000000000000000000000000
10000000000000000000000000000000000000000000000000000000000000000000000000000000000000000000100000000000000000000000000000000000
10000000000000000000000000000000000000000000000000000000000000000000000000000000000000000000100000000000000000000000000000000000
10000000000000000000000000000000000000000000000000000000000000000000000000000000000000000000100000000000000000000000000000000000
10000000000000000000000000000000000000000000000000000000000000000000000000000000000000000000100000000000000000000000000000000000
10000000000000000000000000000000000000000000000000000000000000000000000000000000000000000000100000000000000000000000000000000000
10000000000000000000000000000000000000000000000000000000000000000000000000000000000000000000100000000000000000000000000000000000
10000000000000000000000000000000000000000000000000000000000000000000000000000000000000000000100000000000000000000000000000000000
10000000000000000000000000000000000000000000000000000000000000000000000000000000000000000000100000000000000000000000000000000000
10000000000000000000000000000000000000000000000000000000000000000000000000000000000000000000100000000000000000000000000000000000
10000000000000000000000000000000000000000000000000000000000000000000000000000000000000000000100000000000000000000000000000000000
10000000000000000000000000000000000000000000000000000000000000000000000000000000000000000000100000000000000000000000000000000000
10000000000000000000000000000000000000000000000000000000000000000000000000000000000000000000100000000000000000000000000000000000
10000000000000000000000000000000000000000000000000000000000000000000000000000000000000000000111111111111111111111111111111111111
10000000000000000000000000000000000000000000000000000000000000000000000000000000000000000000000000000000000000000000000000000001
10000000000000000000000000000000000000000000000000000000000000000000000000000000000000000000000000000000000000000000000000000001
10000000000000000000000000000000000000000000000000000000000000000000000000000000000000000000000000000000000000000000000000000001
10000000000000000000000000000000000000000000000000000000000000000000000000000000000000000000000000000000000000000000000000000001
10000000000000000000000000000000000000000000000000000000000000000000000000000000000000000000000000000000000000000000000000000001
10000000000000000000000000000000000000000000000000000000000000000000000000000000000000000000000000000000000000000000000000000001
10000000000000000000000000000000000000000000000000000000000000000000000000000000000000000000000000000000000000000000000000000001
10000000000000000000000000000000000000000000000000000000000000000000000000000000000000000000000000000000000000000000000000000001
10000000000000000000000000000000000000000000000000000000000000000000000000000000000000000000000000000000000000000000000000000001
10000000000000000000000000000000000000000000000000000000000000000000000000000000000000000000000000000000000000000000000000000001
10000000000000000000000000000000000000000000000000000000000000000000000000000000000000000000000000000000000000000000000000000001
10000000000000000000000000000000000000000000000000000000000000000000000000000000000000000000000000000000000000000000000000000001
10000000000000000000000000000000000000000000000000000000000000000000000000000000000000000000000000000000000000000000000000000001
10000000000000000000000000000000000000000000000000000000000000000000000000000000000000000000000000000000000000000000000000000001
10000000000000000000000000000000000000000000000000000000000000000000000000000000000000000000000000000000000000000000000000000001
10000000000000000000000000000000000000000000000000000000000000000000000000000000000000000000000000000000000000000000000000000001
10000000000000000000000000000000000000000000000000000000000000000000000000000000000000000000000000000000000000000000000000000001
10000000000000000000000000000000000000000000000000000000000000000000000000000000000000000000000000000000000000000000000000000001
10000000000000000000000000000000000000000000000000000000000000000000000000000000000000000000000000000000000000000000000000000001
10000000000000000001111111111111111111111111111111111111111111111111111111111111111111111111111110000000000000000000000000000001
10000000000000000001000000000000000000000000000000000000000000000000000000000000000000000000000010000000000000000000000000000001
10000000000000000001000000000000000000000000000000000000000000000000000000000000000000000000000010000000000000000000000000000001
10000000000000000001111111111111111111111111111111111111111111111111111111111111111111110000000010000000000000000000000000000001
10000000000000000000000000000000000000000000000000000000000000000000000000000000000000010000000010000000000000000000000000000001
10000000000000000000000000000000000000000000000000000000000000000000000000000000000000010000000010000000000000000000000000000001
10000000000000000000000000000000000000000000000000000000000000000000000000000000000000010000000010000000000000000000000000000001
10000000000000000000000000000000000000000000000000000000000000000000000000000000000000010000000010000000000000000000000000000001
10000000000000000000000000000000000000000000000000000000000000000000000000000000000000010000000010000000000000000000000000000001
10000000000000000000000000000000000000000000000000000000000000000000000000000000000000010000000010000000000000000000000000000001
10000000000000000000000000000000000000000000000000000000000000000000000000000000000000010000000010000000000000000000000000000001
10000000000000000000000000000000000000000000000000000000000000000000000000000000000000010000000010000000000000000000000000000001
10000000000000000000000000000000000000000000000000000000000000000000000000000000000000010000000010000000000000000000000000000001
10000000000000000000000000000000000000000000000000000000000000000000000000000000000000010000000010000000000000000000000000000001
10000000000000000000000000000000000000000000000000000000000000000000000000000000000000010000000010000000000000000000000000000001
10000000000000000000000000000000000000000000000000000000000000000000000000000000000000010000000010000000000000000000000000000001
10000000000000000000000000000000000000000000000000000000000000000000000000000000000000010000000010000000000000000000000000000001
10000000000000000000000000000000000000000000000000000000000000000000000000000000000000010000000010000000000000000000000000000001
10000000000000000000000000000000000000000000000000000000000000000000000000000000000000010000000010000000000000000000000000000001
10000000000000000000000000000000000000000000000000000000000000000000000000000000000000010000000010000000000000000000000000000001
10000000000000000000000000000000000000000000000000000000011111111110000000000000000000010000000010000000000000000000000000000001
10000000000000000000000000000000000000000000000000000000010000000010000000000000000000010000000010000000000000000000000000000001
10000000000000000000000000000000000000000000000000000000010000000010000000000000000000010000000010000000000000000000000000000001
10000000000000000000000000000000000000000000000000000000010000000010000000000000000000010000000010000000000000000000000000000001
10000000000000000000000000000000000000000000000000000000010000000010000000000000000000010000000010000000000000000000000000000001
10000000000000000000000000000000000000000000000000000000010000000010000000000000000000010000000010000000000000000000000000000001
10000000000000000000000000000000000000000000000000000000010000000010000000000000000000010000000010000000000000000000000000000001
10000000000000000000000000000000000000000000000000000000010000000010000000000000000000010000000010000000000000000000000000000001
10000000000000000000000000000000000000000000000000000000010000000010000000000000000000010000000010000000000000000000000000000001
10000000000000000000000000000000000000000000000000000000010000000010000000000000000000010000000010000000000000000000000000000001
10000000000000000000000000000000000000000000000000000000010000000010000000000000000000010000000010000000000000000000000000000001
11111111111111111111111111111111111111111111111111111111110000000010000000000000000000010000000010000000000000000000000000000001
00000000000000000000000000000000000000000000000000000000000000000010000000000000000000010000000010000000000000000000000000000001
00000000000000000000000000000000000000000000000000000000000000000010000000000000000000010000000010000000000000000000000000000001
11111111111111111111111111111111111111111111111111111111111111111111111100000000001111111111111110000000000000000000000000000001
10000000000000000000000000000000000000000000000000000000000000000000000100000000001000000000000000000000000000000000000000000001
10000000000000000000000000000000000000000000000000000000000000000000000100000000001000000000000000000000000000000000000000000001
10000000000000000000000000000000000000000000000000000000000000000000000100000000001000000000000000000000000000000000000000000001
10000000000000000000000000000000000000000000000000000000000000000000000100000000001000000000000000000000000000000000000000000001
10000000000000000000000000000000000000000000000000000000000000000000000100000000001000000000000000000000000000000000000000000001
10000000000000000000000000000000000000000000000000000000000000000000000100000000001000000000000000000000000000000000000000000001
10000000000000000000000000000000000000000000000000000000000000000000000100000000001000000000000000000000000000000000000000000001
10000000000000000000000000000000000000000000000000000000000000000000000100000000001000000000000000000000000000000000000000000001
10000000000000000000000000000000000000000000000000000000000000000000000100000000001000000000000000000000000000000000000000000001
10000000000000000000000000000000000000000000000000000000000000000000000100000000001000000000000000000000000000000000000000000001
10000000000000000000000000000000000000000000000000000000000000000000000100000000001000000000000000000000000000000000000000000001
10000000000000000000000000000000000000000000000000000000000000000000000100000000001000000000000000000000000000000000000000000001
10000000000000000000000000000000000000000000000000000000000000000000000100000000001000000000000000000000000000000000000000000001
10000000000000000000000000000000000000000000000000000000000000000000000100000000001000000000000000000000000000000000000000000001
10000000000000000000000000000000000000000000000000000000000000000000000100000000001000000000000000000000000000000000000000000001
10000000000000000000000000000000000000000000000000000000000000000000000100000000001000000000000000000000000000000000000000000001
10000000000000000000000000000000000000000000000000000000000000000000000100000000001000000000000000000000000000000000000000000001
10000000000000000000000000000000000000000000000000000000000000000000000100000000001000000000000000000000000000000000000000000001
10000000000000000000000000000001111111111111111111111111111111111111111100000000001111111111111111111111111111111111111111111111
10000000000000000000000000000001000000000000000000000000000000000010000000000000000000010000000000000000000000000000000000000000
10000000000000000000000000000111000000000000000000000000000000000010000000000000000000010000000000000000000000000000000000000000
10000000000000000000000000000100000000000000000000000000000000000010000000000000000000010000000000000000000000000000000000000000
10000000000000000000000000011100011111111111111111111111111111111110000000000000000000010000000000000000000000000000000000000000
10000000000000000000000000010000010000000000000000000000000000000000000000000000000000010000000000000000000000000000000000000000
10000000000000000000000001110111110000000000000000000000000000000000000000000000000000010000000000000000000000000000000000000000
10000000000000000000000111000100000000000000000000000000000000000000000000000000000000010000000000000000000000000000000000000000
10000000000000000000000100011100000000000000000000000000000000000000000000000000000000010000000000000000000000000000000000000000
10000000000000000000000111110000000000000000000000000000000000000000000000000000000000010000000000000000000000000000000000000000
10000000000000000000000000000000000000000000000000000000000000000000000000000000000000010000000000000000000000000000000000000000
10000000000000000000000000000000000000000000000000000000000000000000000000000000000000010000000000000000000000000000000000000000
10000000000000000000000000000000000000000000000000000000000000000000000000000000000000010000000000000000000000000000000000000000
10000000000000000000000000000000000000000000000000000000000000000000000000000000000000010000000000000000000000000000000000000000
10000000000000000000000000000000000000000000000000000000000000000000000000000000000000010000000000000000000000000000000000000000
10000000000000000000000000000000000000000000000000000000000000000000000000000000000000010000000000000000000000000000000000000000
10000000000000000000000000000000000000000000000000000000000000000000000000000000000000010000000000000000000000000000000000000000
10000000000000000000000000000000000000000000000000000000000000000000000000000000000000010000000000000000000000000000000000000000
10000000000000000000000000000000000000000000000000000000000000000000000000000000000000010000000000000000000000000000000000000000
10000000000000000000000000000000000000000000000000000000000000000000000000000000000000010000000000000000000000000000000000000000
10000000000000000000000000000000000000000000000000000000000000000000000000000000000000010000000000000000000000000000000000000000
10000000000000000000000000000000000000000000000000000000000000000000000000000000000000010000000000000000000000000000000000000000
10000000000000000000000000000000000000000000000000000000000000000000000000000000000000010000000000000000000000000000000000000000
10000000000000000000000000000000000000000000000000000000000000000000000000000000000000010000000000000000000000000000000000000000
10000000000000000000000000000000000000000000000000000000000000000000000000000000000000010000000000000000000000000000000000000000
10000000000000000000000000000000000000000000000000000000000000000000000000000000000000010000000000000000000000000000000000000000
10000000000000000000000000000000000000000000000000000000000000000000000000000000000000010000000000000000000000000000000000000000
10000000000000000000000000000000000000000000000000000000000000000000000000000000000000010000000000000000000000000000000000000000
10000000000000000000000000000000000000000000000000000000000000000000000000000000000000010000000000000000000000000000000000000000
10000000000000000000000000000000000000000000000000000000000000000000000000000000000000010000000000000000000000000000000000000000
11111111111111111111111111111111111111111111111111111111111111111111111111111111111111110000000000000000000000000000000000000000
